******************X****
******************.****
******************.****
*********..........****
*********.*************
*********.*************
*********.*************
*****.........*********
*************.*********
*************.*********
*************.*********
*******........********
*******.***************
****...........********
****.*****.************
****.*****.************
****.*****.************
****.*****.************
****.*****.......******
****.*****.************
****.****.....*********
****.****.*************
****..***.*************
*****.***.*************
*****..**.*************
******.**.*************
***.**.*..*************
***.**....*************
***....****************
*****.*****************
*****.*****************
*............**********
************.**********
**********.....********
**********.************
*******......**********
************.**********
*****...****.**********
*******.****.**********
*******.****.**********
****............*******
****.**********.*******
****.******************
****.**.......*********
****.********.*********
***.....*****.*********
*******....**.*********
**********.**.*********
**********....*********
***********.***********
***********.***********
*******........********
**************@********
***********************
***********************
